                LOR   Seq. Line of Route Description                                                                                                                   Route                 Last Updated




October 2009
               NW0001 008 Explanation of Table A terms and symbols                                                                                                   LNW North                16/10/2021

                                                             Explanation of Table A terms and symbols - Continued
                  11. Other abbreviations                                                                        Infrastructure abbreviations:

                 In addition to the abbreviations already listed (e.g. for type of signalling or type of level   C:      Catch points, unworked              C&P:  Clipped and padlocked out of use.
                 crossing), the following abbreviations may also be used on Table A diagrams without             CW:     Catch points, worked.               HABD: Hot Axle Box Detector.
                 explantion:                                                                                     Jn:     Junction.                           WILD: Wheel Impact Load Detector.

                  Line name abbreviations:

                  U:   Up                                         D:     Down
                  UM: Up Main                                     DM:    Down Main
                                                                                                                 Railway lines of route abbreviations:
                  UF: Up Fast                                     DF:    Down Fast
                                                                                                                                                                                                             LNW North Route Sectional Appendix Module NWF




                  US: Up Slow                                     DS:    Down Slow                               LUL:     London Underground Ltd             HS1:  High Speed 1.
                  UE: Up Electric                                 DE:    Down Electric                           CTRL:    Channel Tunnel Rail Link (HS1).    HS2:  High Speed 2.
                  UR: Up Relief                                   DR:    Down Relief                             WCML:    West Coast Main Line.              CCOS: Crossrail Central Operating Section.
                  UA: Up Avoiding                                 DA:    Down Avoiding                           ECML:    East Coast Main Line.
                  UG: Up Goods                                    DG:    Down Goods




66
                  USB: Up Suburban                                DSB:   Down Suburban
                  UPL: Up Passenger Loop                          DPL:   Down Passenger Loop
                                                                                                                                                                                                                                                             OFFICIAL




                  UGL: Up Goods Loop                              DGL:   Down Goods Loop
                  URS: Up Refuge Siding                           DRS:   Down Refuge Siding                      Other abbreviations which may be used without explanation:
                  CL: Crossing Loop (in single line)              U&D:   Up & Down
                                                                                                                 OOU:     Out of use.
                                                                                                                 TEP:     Token Exchange Point - applicable to lines signalled using the 'Radio Electronic
                  Signalling control abbreviations:                                                                       Token Block' or the 'No Signaller Token with Remote Crossing Loops' methods of
                                                                                                                          signalling.
                 SB:      Signal box.                             GF:    Ground Frame.                           CTLP:    Crossing the line procedure.
                 PSB:     Power signal box.                       EGF:   Emergency Ground Frame.
                 SCC:     Signalling control centre.              GSP:   Ground Switch Panel.
                 SC:      Signalling centre.                      SF:    Shunt Frame.
                 IECC:    Integrated Electronic Control
                          Centre.
                  ROC:    Rail Operations Centre.
